***********
* P        *
*    M    *
*       G  *
*	*
*	*
*	*
***********